"filename", "language", "Dart", "Java Properties", "Gradle", "XML", "Kotlin", "comment", "blank", "total"
"d:\Softwares\FLUTTER\FlutterProjects\TinnitusQuiz_Splash\android\app\build.gradle", "Gradle", 0, 0, -57, 0, 0, -33, -18, -108
"d:\Softwares\FLUTTER\FlutterProjects\TinnitusQuiz_Splash\android\app\src\debug\AndroidManifest.xml", "XML", 0, 0, 0, -3, 0, -4, -1, -8
"d:\Softwares\FLUTTER\FlutterProjects\TinnitusQuiz_Splash\android\app\src\main\AndroidManifest.xml", "XML", 0, 0, 0, -34, 0, -11, -2, -47
"d:\Softwares\FLUTTER\FlutterProjects\TinnitusQuiz_Splash\android\app\src\main\kotlin\com\example\qehs\MainActivity.kt", "Kotlin", 0, 0, 0, 0, -38, -17, -12, -67
"d:\Softwares\FLUTTER\FlutterProjects\TinnitusQuiz_Splash\android\app\src\main\res\drawable\launch_background.xml", "XML", 0, 0, 0, -4, 0, -14, -7, -25
"d:\Softwares\FLUTTER\FlutterProjects\TinnitusQuiz_Splash\android\app\src\main\res\layout\launch_screen.xml", "XML", 0, 0, 0, -11, 0, -1, -1, -13
"d:\Softwares\FLUTTER\FlutterProjects\TinnitusQuiz_Splash\android\app\src\main\res\values-night\colors.xml", "XML", 0, 0, 0, -6, 0, 0, 0, -6
"d:\Softwares\FLUTTER\FlutterProjects\TinnitusQuiz_Splash\android\app\src\main\res\values-night\styles.xml", "XML", 0, 0, 0, -11, 0, -11, -3, -25
"d:\Softwares\FLUTTER\FlutterProjects\TinnitusQuiz_Splash\android\app\src\main\res\values-v21\styles.xml", "XML", 0, 0, 0, -7, 0, 0, -4, -11
"d:\Softwares\FLUTTER\FlutterProjects\TinnitusQuiz_Splash\android\app\src\main\res\values\colors.xml", "XML", 0, 0, 0, -6, 0, 0, -1, -7
"d:\Softwares\FLUTTER\FlutterProjects\TinnitusQuiz_Splash\android\app\src\main\res\values\styles.xml", "XML", 0, 0, 0, -13, 0, -22, -7, -42
"d:\Softwares\FLUTTER\FlutterProjects\TinnitusQuiz_Splash\android\app\src\profile\AndroidManifest.xml", "XML", 0, 0, 0, -3, 0, -4, -1, -8
"d:\Softwares\FLUTTER\FlutterProjects\TinnitusQuiz_Splash\android\build.gradle", "Gradle", 0, 0, -27, 0, 0, 0, -5, -32
"d:\Softwares\FLUTTER\FlutterProjects\TinnitusQuiz_Splash\android\gradle.properties", "Java Properties", 0, -3, 0, 0, 0, 0, -1, -4
"d:\Softwares\FLUTTER\FlutterProjects\TinnitusQuiz_Splash\android\gradle\wrapper\gradle-wrapper.properties", "Java Properties", 0, -5, 0, 0, 0, -1, -1, -7
"d:\Softwares\FLUTTER\FlutterProjects\TinnitusQuiz_Splash\android\settings.gradle", "Gradle", 0, 0, -8, 0, 0, 0, -4, -12
"d:\Softwares\FLUTTER\FlutterProjects\TinnitusQuiz_Splash\lib\Quizs_Page\aQuizPage.dart", "Dart", 1797, 0, 0, 0, 0, 256, 133, 2186
"d:\Softwares\FLUTTER\FlutterProjects\TinnitusQuiz_Splash\lib\Quizs_Page\aQuizResultPage.dart", "Dart", 214, 0, 0, 0, 0, 36, 14, 264
"d:\Softwares\FLUTTER\FlutterProjects\TinnitusQuiz_Splash\lib\configs\app_colors.dart", "Dart", 16, 0, 0, 0, 0, 1, 3, 20
"d:\Softwares\FLUTTER\FlutterProjects\TinnitusQuiz_Splash\lib\configs\media_QSize.dart", "Dart", 19, 0, 0, 0, 0, 2, 4, 25
"d:\Softwares\FLUTTER\FlutterProjects\TinnitusQuiz_Splash\lib\drafts.dart", "Dart", 113, 0, 0, 0, 0, 0, 7, 120
"d:\Softwares\FLUTTER\FlutterProjects\TinnitusQuiz_Splash\lib\main.dart", "Dart", 118, 0, 0, 0, 0, 32, 22, 172
"d:\Softwares\FLUTTER\FlutterProjects\TinnitusQuiz_Splash\lib\quiz_models\Answer.dart", "Dart", 18, 0, 0, 0, 0, 0, 5, 23
"d:\Softwares\FLUTTER\FlutterProjects\TinnitusQuiz_Splash\lib\quiz_models\Aspectscored.dart", "Dart", 20, 0, 0, 0, 0, 0, 5, 25
"d:\Softwares\FLUTTER\FlutterProjects\TinnitusQuiz_Splash\lib\quiz_models\PsqiAns.dart", "Dart", 13, 0, 0, 0, 0, 1, 4, 18
"d:\Softwares\FLUTTER\FlutterProjects\TinnitusQuiz_Splash\lib\quiz_models\Question.dart", "Dart", 20, 0, 0, 0, 0, 0, 6, 26
"d:\Softwares\FLUTTER\FlutterProjects\TinnitusQuiz_Splash\lib\quiz_models\QuizInfo.dart", "Dart", 38, 0, 0, 0, 0, 18, 7, 63
"d:\Softwares\FLUTTER\FlutterProjects\TinnitusQuiz_Splash\lib\quiz_models\Quiz_types.dart", "Dart", 7, 0, 0, 0, 0, 1, 1, 9
"d:\Softwares\FLUTTER\FlutterProjects\TinnitusQuiz_Splash\lib\quiz_models\QuizeLoadHelper.dart", "Dart", 37, 0, 0, 0, 0, 3, 5, 45
"d:\Softwares\FLUTTER\FlutterProjects\TinnitusQuiz_Splash\lib\quiz_models\ResultRankRef.dart", "Dart", 18, 0, 0, 0, 0, 0, 5, 23
"d:\Softwares\FLUTTER\FlutterProjects\TinnitusQuiz_Splash\lib\quiz_models\StoreQuizsTodate.dart", "Dart", 26, 0, 0, 0, 0, 4, 6, 36
"d:\Softwares\FLUTTER\FlutterProjects\TinnitusQuiz_Splash\lib\quiz_models\UserResultRecord.dart", "Dart", 27, 0, 0, 0, 0, 0, 6, 33
"d:\Softwares\FLUTTER\FlutterProjects\TinnitusQuiz_Splash\lib\quiz_models\getQrString.dart", "Dart", 0, 0, 0, 0, 0, 5, 2, 7
"d:\Softwares\FLUTTER\FlutterProjects\TinnitusQuiz_Splash\lib\routers\routers.dart", "Dart", 0, 0, 0, 0, 0, 41, 7, 48
"d:\Softwares\FLUTTER\FlutterProjects\TinnitusQuiz_Splash\lib\sections\SectionsNavigator.dart", "Dart", 57, 0, 0, 0, 0, 42, 8, 107
"d:\Softwares\FLUTTER\FlutterProjects\TinnitusQuiz_Splash\lib\sections\qrDisplayPage.dart", "Dart", 42, 0, 0, 0, 0, 107, 11, 160
"d:\Softwares\FLUTTER\FlutterProjects\TinnitusQuiz_Splash\lib\sections\quizLocalHisPage.dart", "Dart", 110, 0, 0, 0, 0, 73, 15, 198
"d:\Softwares\FLUTTER\FlutterProjects\TinnitusQuiz_Splash\lib\sections\quizSelectionPage.dart", "Dart", 343, 0, 0, 0, 0, 67, 11, 421
"d:\Softwares\FLUTTER\FlutterProjects\TinnitusQuiz_Splash\lib\widgets\foldingcell.dart", "Dart", 180, 0, 0, 0, 0, 15, 24, 219
"d:\Softwares\FLUTTER\FlutterProjects\TinnitusQuiz_Splash\lib\widgets\mybutton.dart", "Dart", 34, 0, 0, 0, 0, 0, 5, 39
"d:\Softwares\FLUTTER\FlutterProjects\TinnitusQuiz_Splash\lib\widgets\mytimepicker.dart", "Dart", 103, 0, 0, 0, 0, 7, 10, 120
"d:\Softwares\FLUTTER\FlutterProjects\TinnitusQuiz_Splash\lib\widgets\radiotile_options.dart", "Dart", 64, 0, 0, 0, 0, 40, 24, 128
"d:\Softwares\FLUTTER\FlutterProjects\TinnitusQuiz_Splash\lib\widgets\slider0_10.dart", "Dart", 131, 0, 0, 0, 0, 14, 11, 156
"Total", "-", 3565, -8, -92, -98, -38, 647, 293, 4269