"filename", "language", "Dart", "JSON", "comment", "blank", "total"
"d:\Softwares\FLUTTER\FlutterProjects\TinnitusQuiz_Splash\assets\questionnaires\PSQI_5.json", "JSON", 0, -540, 0, 0, -540
"d:\Softwares\FLUTTER\FlutterProjects\TinnitusQuiz_Splash\assets\questionnaires\TEQ_4.json", "JSON", 0, -180, 0, -1, -181
"d:\Softwares\FLUTTER\FlutterProjects\TinnitusQuiz_Splash\assets\questionnaires\TFI_3.json", "JSON", 0, -397, 0, 0, -397
"d:\Softwares\FLUTTER\FlutterProjects\TinnitusQuiz_Splash\assets\questionnaires\THI_1.json", "JSON", 0, -673, 0, 0, -673
"d:\Softwares\FLUTTER\FlutterProjects\TinnitusQuiz_Splash\assets\questionnaires\VAS_2.json", "JSON", 0, -146, 0, 0, -146
"d:\Softwares\FLUTTER\FlutterProjects\TinnitusQuiz_Splash\lib\Quizs_Page\aQuizPage.dart", "Dart", 1794, 0, 236, 130, 2160
"d:\Softwares\FLUTTER\FlutterProjects\TinnitusQuiz_Splash\lib\Quizs_Page\aQuizResultPage.dart", "Dart", 215, 0, 43, 14, 272
"d:\Softwares\FLUTTER\FlutterProjects\TinnitusQuiz_Splash\lib\Quizs_Page\qrDisplay.dart", "Dart", 42, 0, 106, 11, 159
"d:\Softwares\FLUTTER\FlutterProjects\TinnitusQuiz_Splash\lib\Quizs_Page\quizLocalHispage.dart", "Dart", 92, 0, 93, 10, 195
"d:\Softwares\FLUTTER\FlutterProjects\TinnitusQuiz_Splash\lib\SectionsNavigator.dart", "Dart", 57, 0, 41, 8, 106
"d:\Softwares\FLUTTER\FlutterProjects\TinnitusQuiz_Splash\lib\configs\app_colors.dart", "Dart", 16, 0, 1, 3, 20
"d:\Softwares\FLUTTER\FlutterProjects\TinnitusQuiz_Splash\lib\configs\media_QSize.dart", "Dart", 19, 0, 2, 4, 25
"d:\Softwares\FLUTTER\FlutterProjects\TinnitusQuiz_Splash\lib\loginpage.dart", "Dart", 94, 0, 15, 5, 114
"d:\Softwares\FLUTTER\FlutterProjects\TinnitusQuiz_Splash\lib\main.dart", "Dart", 115, 0, 29, 23, 167
"d:\Softwares\FLUTTER\FlutterProjects\TinnitusQuiz_Splash\lib\quiz_models\Answer.dart", "Dart", 18, 0, 0, 5, 23
"d:\Softwares\FLUTTER\FlutterProjects\TinnitusQuiz_Splash\lib\quiz_models\Aspectscored.dart", "Dart", 20, 0, 0, 5, 25
"d:\Softwares\FLUTTER\FlutterProjects\TinnitusQuiz_Splash\lib\quiz_models\PsqiAns.dart", "Dart", 13, 0, 1, 4, 18
"d:\Softwares\FLUTTER\FlutterProjects\TinnitusQuiz_Splash\lib\quiz_models\Question.dart", "Dart", 20, 0, 0, 6, 26
"d:\Softwares\FLUTTER\FlutterProjects\TinnitusQuiz_Splash\lib\quiz_models\QuizInfo.dart", "Dart", 38, 0, 18, 7, 63
"d:\Softwares\FLUTTER\FlutterProjects\TinnitusQuiz_Splash\lib\quiz_models\Quiz_types.dart", "Dart", 7, 0, 1, 1, 9
"d:\Softwares\FLUTTER\FlutterProjects\TinnitusQuiz_Splash\lib\quiz_models\QuizeLoadHelper.dart", "Dart", 37, 0, 3, 5, 45
"d:\Softwares\FLUTTER\FlutterProjects\TinnitusQuiz_Splash\lib\quiz_models\ResultRankRef.dart", "Dart", 18, 0, 0, 5, 23
"d:\Softwares\FLUTTER\FlutterProjects\TinnitusQuiz_Splash\lib\quiz_models\StoreQuizsTodate.dart", "Dart", 14, 0, 8, 6, 28
"d:\Softwares\FLUTTER\FlutterProjects\TinnitusQuiz_Splash\lib\quiz_models\UserResultRecord.dart", "Dart", 27, 0, 0, 6, 33
"d:\Softwares\FLUTTER\FlutterProjects\TinnitusQuiz_Splash\lib\quiz_models\getQrString.dart", "Dart", 0, 0, 5, 2, 7
"d:\Softwares\FLUTTER\FlutterProjects\TinnitusQuiz_Splash\lib\routers\routers.dart", "Dart", 0, 0, 41, 7, 48
"d:\Softwares\FLUTTER\FlutterProjects\TinnitusQuiz_Splash\lib\sections\quizsSelection_section.dart", "Dart", 342, 0, 66, 11, 419
"d:\Softwares\FLUTTER\FlutterProjects\TinnitusQuiz_Splash\lib\widgets\foldingcell.dart", "Dart", 180, 0, 15, 24, 219
"d:\Softwares\FLUTTER\FlutterProjects\TinnitusQuiz_Splash\lib\widgets\mybutton.dart", "Dart", 34, 0, 0, 5, 39
"d:\Softwares\FLUTTER\FlutterProjects\TinnitusQuiz_Splash\lib\widgets\mytimepicker.dart", "Dart", 103, 0, 7, 10, 120
"d:\Softwares\FLUTTER\FlutterProjects\TinnitusQuiz_Splash\lib\widgets\radiotile_options.dart", "Dart", 64, 0, 40, 24, 128
"d:\Softwares\FLUTTER\FlutterProjects\TinnitusQuiz_Splash\lib\widgets\slider0_10.dart", "Dart", 131, 0, 14, 11, 156
"Total", "-", 3510, -1936, 785, 351, 2710